##############################
#                            #
#                            #
#                            #
#          ===               #
#                            #
#                            #
#                            #
#                            #
#     @                ======#
##############################